11111111111111
1P000000000001
1010001E001101
1010001E001001
1010001E001001
1010001E000C01
11111111111111
