1111111111
1P00000001
1010001E01
1111111111
