11111111
10011001
1001E011
11011011
100C0001
1P110001
11111111