11111111
1C0110C1
1001E011
1101C011
10000011
1P110001
11111111