11111111
100110E1
10010011
1011C011
100P0111
10011111
11111111