11111111111111
1P000000001001
101001E0011011
1010001E001001
1010001E001001
1010001E000C01
11111111111111