111111111111111111111
1C10100000C0110000C11
1100000111000CC0000C1
100011C0000C0CC111001
11111100000100C000011
10010C000P0C0110000C1
1000011111000CC000001
100011000C000CC111001
11111100C001000001E11
111111111111111111111