111111111111111111111
1000000000C0110000C11
100P100111000CC0000C1
100011C0000C0CC111001
11111100000100C000011
10010C00000C0110000C1
1000011111000CC000001
100011000C000CC1110C1
11111100C00100C000011
1000000111000CC0000C1
100011C0000C0CC111001
11111100000100C000011
10010C00000C0110000C1
1000011111000CC000001
1000011111000CC000001
1000000111000CC0000C1
100011C0000C0CC111001
11111100000100C000111
100011000C000CC1110E1
1000110000C00CC111101
1000000111000CC0000C1
111111111111111111111