11111111111111
1P000000001001
101001E0011011
10100010001001
10100010001001
10100010000C01
11111111111111