111111111111111111111111111111111
1C1010000000110000010001000011001
1P0000011100000000000001000000C01
100011000000000111000001010010C01
11111100000100C000010010011111101
10010000000C0110001C001001C010001
1000011111000CC0000001C001001E001
100011000C000CC111000100010010001
11111100C0010000010100000001CC101
111111111111111111111111111111111