111111111111111111111
1C1010000000110000011
100000011100000000001
100011000000000111001
11111100000100C000011
10010000P00C0110001C1
1000011111000CC000001
100011000C000CC111001
11111100C001000001E11
111111111111111111111